12 12
___ ___ ___ ___ ___ ___ ___ ___ ___ ___ ### ___
___ ___ ___ ___ +14 ___ ___ ___ ### ### Z01 ###
___ ___ X14 A11 ___ ___ ### ### ___ ___ ### ###
___ -11 ___ ___ ___ ___ ___ Z02 ### ### ___ ___
___ ___ ___ ___ ___ ### ___ ### ___ ___ ___ ___
___ ___ ___ ___ ___ ### ___ ### ___ ___ ___ ___
___ ___ ___ ___ ___ ### ___ ### ___ ___ ___ ___
___ ___ ___ ___ ### ### ___ ### ___ ___ ___ ___
___ ___ ### ### ___ C01 ### ___ ___ ___ B11 +14
### ### C02 ___ ### ### ___ ___ -11 Y14 ___ ___
___ ### ### ### ___ ___ ___ ___ ___ ___ ___ ___
___ ___ ___ ___ ___ ___ ___ ___ ___ ___ ___ ___
