10 10
___ ___ ___ ___ ___ ___ ___ ___ ___ ___
___ ___ ___ ___ ___ ___ ### ___ ___ ___
___ ___ A__ ### ### ### ### ___ X__ ___
___ ___ ___ ### ___ ___ ### ___ ___ ___
___ ___ ___ ### ___ ___ ___ ___ ___ ___
___ ___ ___ ___ ___ ___ ### ___ ___ ___
___ ___ ___ ### ___ ___ ### ___ ___ ___
___ B__ ___ ### ### ### ### Y__ ___ ___
___ ___ ___ ### ___ ___ ___ ___ ___ ___
___ ___ ___ ___ ___ ___ ___ ___ ___ ___
