10 10
___ ___ ___ ___ ___ ___ ___ ___ ___ ___
___ ___ ___ ___ ___ ___ ### ___ ___ ___
___ ___ A33 ### ### ### ### ___ Y14 ___
___ ___ -46 ### Z01 C01 ### -61 ___ ___
___ ___ ___ ### ___ ___ ___ ___ C02 ___
___ Z02 ___ ___ ___ ___ ### ___ ___ ___
___ ___ +64 ### Z03 C03 ### +43 ___ ___
___ B11 ___ ### ### ### ### X36 ___ ___
___ ___ ___ ### ___ ___ ___ ___ ___ ___
___ ___ ___ ___ ___ ___ ___ ___ ___ ___
