25 10
Z01 ___ ___ ### C01 ### ___ ___ ### ___ C02 ___ ___ ___ ___ ___ ___ ___ ___ ___ ___ ___ -31 X34 Y34
___ ### ___ ___ ___ Z02 ### ___ ___ ___ ### ___ ___ ___ ___ ___ ___ ___ ___ ___ ___ ___ ___ -51 ___
___ ___ ___ ___ ### ___ ___ ___ ### ___ ___ ___ ### C03 ___ ___ ___ ___ ___ ___ ___ ___ ___ ___ ___
___ ___ ___ ___ Z03 ___ ### ___ ___ ___ ___ ___ ___ ___ ### ___ ___ ___ ___ ___ ___ ___ ___ ___ ___
___ ___ ___ ___ ___ ___ ___ ___ ### ___ -12 ### -11 +14 ___ ___ ### ___ C04 ___ ___ ___ ___ ___ ___
___ ___ ___ ___ ___ ___ ___ Z04 ___ ___ ___ +15 ___ ___ ### ___ ___ ___ ___ ___ ___ ___ ___ ___ ___
___ ___ ___ ___ ___ ___ ___ ___ ___ ### Z05 ### ___ ___ ___ ___ ___ ### ___ ### ___ ___ C05 ___ ___
___ ___ ___ ___ ___ ___ ___ ___ ___ ___ ___ ___ ___ ### ___ ___ ___ ___ ### ___ ___ ### ___ ___ ___
A41 -54 ___ ___ ___ ___ ___ ___ ___ ___ ___ ___ ___ ___ ___ ### ___ ___ ___ ___ ___ ___ ___ ### ___
+11 B44 ___ ___ ___ ___ ___ ___ ___ ___ ___ ___ ___ ___ ___ Z06 ### ___ C06 ### Z07 ### ___ C07 ###

