10 10
___ ___ ___ ___ ___ ___ ___ B25 -51 Z01
___ ___ ___ ___ ___ ___ ___ ___ A41 ___
___ ___ ___ ___ ___ ___ ___ +13 ___ ___
C02 ___ ___ ___ ___ ___ ___ Z03 ___ ___
___ ___ C03 ___ ___ ___ ___ ___ ___ Z02
___ +32 ___ ___ ___ ___ ___ ___ ___ ___
___ Y64 -35 ___ ___ ___ ___ ___ ___ ___
C01 ___ X62 ___ ___ ___ ___ ___ ___ ___
___ ___ ___ ___ ___ ___ ___ ___ ___ ___
___ ___ ___ ___ ___ ___ ___ ___ ___ ___
