10 10
___ ___ ___ ___ ___ ___ ___ B52 -15 Z01
___ ___ ___ ___ ___ ___ ___ ___ A14 ___
___ ___ ___ ___ ___ ___ ___ +31 ___ ___
C02 ___ ___ ___ ___ ___ ___ Z03 ___ ___
___ ___ C03 ___ ___ ___ ___ ___ ___ Z02
___ +23 ___ ___ ___ ___ ___ ___ ___ ___
___ Y46 -53 ___ ___ ___ ___ ___ ___ ___
C01 ___ X26 ___ ___ ___ ___ ___ ___ ___
___ ___ ___ ___ ___ ___ ___ ___ ___ ___
___ ___ ___ ___ ___ ___ ___ ___ ___ ___ 
