10 10
___ ___ ___ ___ ___ ___ ___ B55 -31 Z01
___ ___ ___ ___ ___ ___ ___ ___ A61 ___
___ ___ ___ ___ ___ ___ ___ +23 ___ ___
C02 ___ ___ ___ ___ ___ ___ Z03 ___ ___
___ ___ C03 ___ ___ ___ ___ ___ ___ Z02
___ +42 ___ ___ ___ ___ ___ ___ ___ ___
___ Y14 -45 ___ ___ ___ ___ ___ ___ ___
C01 ___ X12 ___ ___ ___ ___ ___ ___ ___
___ ___ ___ ___ ___ ___ ___ ___ ___ ___
___ ___ ___ ___ ___ ___ ___ ___ ___ ___
